################
#Sicc    cccc  #
#   c   mcm    #
#  mc    c     #
#   bcccccm    #
# #    m       #
################